5

Block
1
4
 5 -1 -1 -1 -1  5 
 4  4  4  4  4  4 
 4  5  5  5  5  4 
 4  5  4  4  5  4 
 4  5  4  4  5  4 
 4  5  4  4  5  4 
 4  5  4  4  5  4 
 4  5  5  5  5  4 
 4  4  4  4  4  4 
-1 -1 -1 -1 -1 -1 
-1 -1 -1 -1 -1 -1 


Cross
1
0
-1 -1  1  0 -1 -1 
-1 -1  0  1 -1 -1 
-1  0  1  0  1 -1 
-1  1  0  1  0 -1 
-1 -1  1  0 -1 -1 
-1 -1  0  1 -1 -1 
-1 -1  1  0 -1 -1 
-1 -1  0  1 -1 -1 
-1 -1  1  0 -1 -1 
-1 -1 -1 -1 -1 -1 
-1 -1 -1 -1 -1 -1 

Snake
1
3
-1 -1 -1  3 -1 -1 
-1 -1  3  2 -1 -1 
-1  3  2 -1 -1 -1 
-1  2 -1 -1 -1 -1 
-1  3  2 -1 -1 -1 
-1 -1  3  2 -1 -1 
-1 -1 -1  3 -1 -1 
-1 -1  3  2 -1 -1 
-1  3  2 -1 -1 -1 
-1  2 -1 -1 -1 -1 
-1 -1 -1 -1 -1 -1 

Astroids
1
1
-1  6 -1  6 -1  6 
 7 -1  7 -1  7 -1 
-1  6 -1  6 -1  6 
 7 -1  7 -1  7 -1 
-1  6 -1  6 -1  6 
 7 -1  7 -1  7 -1 
-1  6 -1  6 -1  6 
 7 -1  7 -1  7 -1 
-1  6 -1  6 -1  6 
 7 -1  7 -1  7 -1 
-1  6 -1  6 -1  6

Fire
2
2
-1 -1 -1 -1 -1 -1 
-1 -1 -1  3 -1 -1 
 3  4 -1  4 -1 -1 
-1  3 -1  3  4 -1 
-1  4  3 -1  3 -1 
-1 -1  4 -1  4 -1 
-1  4  3  4  3 -1 
-1  3  4  3  4 -1 
-1  4  3  4  3 -1 
-1  3  4  3  4 -1 
-1 -1 -1 -1 -1 -1 


Level Name
Number of Balls
Color of background
Array of blocks
-1 -1 -1 -1 -1 -1 
-1 -1 -1 -1 -1 -1 
-1 -1 -1 -1 -1 -1 
-1 -1 -1 -1 -1 -1 
-1 -1 -1 -1 -1 -1 
-1 -1 -1 -1 -1 -1 
-1 -1 -1 -1 -1 -1 
-1 -1 -1 -1 -1 -1 
-1 -1 -1 -1 -1 -1 
-1 -1 -1 -1 -1 -1 
-1 -1 -1 -1 -1 -1 
